"a" = (/turf/open/snow/layer2,/area/space)
"r" = (/obj/structure/tent/big,/obj/structure/tent_curtain,/turf/open/snow/layer2,/area/space)
"s" = (/turf/open/snow/layer0,/area/space)
"C" = (/turf/closed/wall/shiva/ice,/area/space)
"V" = (/obj/structure/tent_curtain,/turf/open/snow/layer2,/area/space)
"Z" = (/turf/open/asphalt/cement,/area/space)

(1,1,1) = {"
CCCCCCCCCCCCCCCCCCCCCCCCCCCCCCCCCCCCCCCCCCCCCCCCCC
CaaaaaaaaaaaaaaaaaaaaaassssaaaaaaaaaaaaaaaaaaaaaaC
CaaaaaaaaaaaaaaaaaaaaaassssaaaaaaaaaaaaaaaaaaaaaaC
CaaaaaaaaaaaaaaaaaaaaaassssaaaaaaaaaaaaaaaaaaaaaaC
CaaaaaaaaaaaaaaaaaaaaaassssaaaaaaaaaaaaaaaaaaaaaaC
CaaaaaaaaaaaaaaaaaaaaaassssaaaaaaaaaaaaaaaaaaaaaaC
CaaaaaaaaaaaaaaaaaaaaaassssaaaaaaaaaaaaaaaaaaaaaaC
CaaaaaaaaaaaaaaaaaaaaaassssaaaaaaaaaaaaaaaaaaaaaaC
CaaaaaaaaaaaaaaaaaaaaaassssaaaaaaaaaaaaaaaaaaaaaaC
CaaaaaaaaaaaaaaaaaaaaaassssaaaaaaaaaaaaaaaaaaaaaaC
CaaaaaaaaaaaaaaaaaaaaaassssaaaaaaaaaaaaaaaaaaaaaaC
CaaaaaaaaaaaaaaaaaaaaaassssaaaaaaaaaaaaaaaaaaaaaaC
CaaaaaaaaaaaaaaaaaaaaaassssaaaaaaaaaaaaaaaaaaaaaaC
CaaaaaaaaaaaaaaaaaaaaaassssaaaaaaaaaaaaaaaaaaaaaaC
CaaaaaaaaaaaaaaaaaaaaaassssaaaaaaaaaaaaaaaaaaaaaaC
CaaaaaaaaaaaaaaaaaaaaaassssaaaaaaaaaaaaaaaaaaaaaaC
CaaaaaaaaaaaaaaaaaaaaaassssaaaaaaaaaaaaaaaaaaaaaaC
CaaaaaaaaaaaaaaaaaaaaaassssaaaaaaaaaaaaaaaaaaaaaaC
CaaaaaaaaaaaaaaaaaaaaaassssaaaaaaaaaaaaaaaaaaaaaaC
CaaaaaaaaaaaaaaaaaaaaaassssaaaaaaaaaaaaaaaaaaaaaaC
CaaaaaaaaaaaaaaaaaaaaaassssaaaaaaaaaaaaaaaaaaaaaaC
CaaaaaaaaaaaaaaaaaaaaaassssaaaaaaaaaaaaaaaaaaaaaaC
CaaaaaaaaaaaaaaaaaaaaaassssaaaaaaaaaaaaaaaaaaaaaaC
CaaaaaaaaaaaaaaaaaaaaaassssaaaaaaaaaaaaaaaaaaaaaaC
CaaaaaaaaaaaaaaaaaaaaaassssaaaaaaaaaaaaaaaaaaaaaaC
CaaaaaaaaaaaaaaaaaaaaaassssaaaaaaaaaaaaaaaaaaaaaaC
CaaaaaaaaaaaaaaaaaaaaaassssaaaaaaaaaaaaaaaaaaaaaaC
CaaaaaaaaaaaaaaaaaaaaaassssaaaaaaaaaaaaaaaaaaaaaaC
CaaaaaaaaaaaaaaaaaaaaaassssaaaaaaaaaaaaaaaaaaaaaaC
CaaaaaaaaaaaaaaaaaaaaaassssaaaaaaaaaaaaaaaaaaaaaaC
CaaaaaaaaaaaaaaaaaaaaaassssaaaaaaaaaaaaaaaaaaaaaaC
CaaaaaaaaaaaaaaaaaaaaaassssaaaaaaaaaaaaaaaaaaaaaaC
CaaaaaaaaaaaaaaaaaaaaaassssaaaaaaaaaaaaaaaaaaaaaaC
CaaaaaaaaaaaaaaaaaaaaaassssaaaaaaaaaaaaaaaaaaaaaaC
CaaaaaaaaaaaaaaaaaaaaaassssaaaaaaaaaaaaaaaaaaaaaaC
CaaaaaaaaaaaaaaaaaaaaaassssaaaaaaaaaaaaaaaaaaaaaaC
CaaaaaaaaaaaaaaaaaaaaaaZsssaaaaaaaaaaaaaaaaaaaaaaC
CaaaaaaaaaaaaaaaaaaaaaaZZsZaaaaaaaaaaaaaaaaaaaaaaC
CaaaaaaaaaaaaaaaaaaaaaaZZZZaaaaaaaaaaaaaaaaaaaaaaC
CaaaaaaaaaaaaaaaaaaaaaaZZZZaaaaaaaaaaaaaaaaaaaaaaC
CaaaaaaaaaaaaaaaaaaaaaaZZZZaaaaaaaaaaaaaaaaaaaaaaC
CaaaaaaaaaaaaaaaaaaaaaaZZZZaaaaaaaaaaaaaaaaaaaaaaC
CaaaaaaaaaaaaaaaaaaaaaaZZZZaaaaaaaaaaaaaaaaaaaaaaC
CaaaaaaaaaaaaaaaaaaaaaaZZZZaaaaaaaaaaaaaaaaaaaaaaC
CaaaaaaaaaaaaaaaaaaaaaaZZZZaaaaaaaaaaaaaaaaaaaaaaC
CaaaaaaaaaaaaaaaaaaaaaaZZZZaaaaaaaaaaaaaaaaaaaaaaC
CaaaaaaaaaaaaaaaaaaaaaaZZZZaaaaaaaaaaaaaaaaaaaaaaC
CaaaaaaaaaaaaaaaaaaaaaaZZZZaaaaaaaaaaaaaaaaaaaaaaC
CaaaaaaaarVVarVVarVVaaaZZZZaaaaaaaaaaaaaaaaaaaaaaC
CaaaaaaaaZZZZZZZZZZZZZZZZZZaaaaaaaaaaaaaaaaaaaaaaC
CaaaaaaaaZZZZZZZZZZZZZZZZZZaaaaaaaaaaaaaaaaaaaaaaC
CaaaaaaaaaaaaaaaaaaaaaaZZZZaaaaaaaaaaaaaaaaaaaaaaC
CaaaaaaaaaaaaaaaaaaaaaaZZZZaaaaaaaaaaaaaaaaaaaaaaC
CaaaaaaaaaaaaaaaaaaaaaaZZZZaaaaaaaaaaaaaaaaaaaaaaC
CaaaaaaaaaaaaaaaaaaaaaaZZZZaaaaaaaaaaaaaaaaaaaaaaC
CaaaaaaaaaaaaaaaaaaaaaaZZZZaaaaaaaaaaaaaaaaaaaaaaC
CaaaaaaaaaaaaaaaaaaaaaaZZZZaaaaaaaaaaaaaaaaaaaaaaC
CaaaaaaaaaaaaaaaaaaaaaaZZZZaaaaaaaaaaaaaaaaaaaaaaC
CaaaaaaaaaaaaaaaaaaaaaaZZZZaaaaaaaaaaaaaaaaaaaaaaC
CaaaaaaaaaaaaaaaaaaaaaaZZZZaaaaaaaaaaaaaaaaaaaaaaC
CaaaaaaaaaaaaaaaaaaaaaaZZZZaaaaaaaaaaaaaaaaaaaaaaC
CaaaaaaaaaaaaaaaaaaaaaaZZsZaaaaaaaaaaaaaaaaaaaaaaC
CaaaaaaaaaaaaaaaaaaaaaaZsssaaaaaaaaaaaaaaaaaaaaaaC
CaaaaaaaaaaaaaaaaaaaaaassssaaaaaaaaaaaaaaaaaaaaaaC
CaaaaaaaaaaaaaaaaaaaaaassssaaaaaaaaaaaaaaaaaaaaaaC
CaaaaaaaaaaaaaaaaaaaaaassssaaaaaaaaaaaaaaaaaaaaaaC
CaaaaaaaaaaaaaaaaaaaaaassssaaaaaaaaaaaaaaaaaaaaaaC
CaaaaaaaaaaaaaaaaaaaaaassssaaaaaaaaaaaaaaaaaaaaaaC
CaaaaaaaaaaaaaaaaaaaaaassssaaaaaaaaaaaaaaaaaaaaaaC
CaaaaaaaaaaaaaaaaaaaaaassssaaaaaaaaaaaaaaaaaaaaaaC
CaaaaaaaaaaaaaaaaaaaaaassssaaaaaaaaaaaaaaaaaaaaaaC
CaaaaaaaaaaaaaaaaaaaaaassssaaaaaaaaaaaaaaaaaaaaaaC
CaaaaaaaaaaaaaaaaaaaaaassssaaaaaaaaaaaaaaaaaaaaaaC
CaaaaaaaaaaaaaaaaaaaaaassssaaaaaaaaaaaaaaaaaaaaaaC
CaaaaaaaaaaaaaaaaaaaaaassssaaaaaaaaaaaaaaaaaaaaaaC
CaaaaaaaaaaaaaaaaaaaaaassssaaaaaaaaaaaaaaaaaaaaaaC
CaaaaaaaaaaaaaaaaaaaaaassssaaaaaaaaaaaaaaaaaaaaaaC
CaaaaaaaaaaaaaaaaaaaaaassssaaaaaaaaaaaaaaaaaaaaaaC
CaaaaaaaaaaaaaaaaaaaaaassssaaaaaaaaaaaaaaaaaaaaaaC
CaaaaaaaaaaaaaaaaaaaaaassssaaaaaaaaaaaaaaaaaaaaaaC
CaaaaaaaaaaaaaaaaaaaaaassssaaaaaaaaaaaaaaaaaaaaaaC
CaaaaaaaaaaaaaaaaaaaaaassssaaaaaaaaaaaaaaaaaaaaaaC
CaaaaaaaaaaaaaaaaaaaaaassssaaaaaaaaaaaaaaaaaaaaaaC
CaaaaaaaaaaaaaaaaaaaaaassssaaaaaaaaaaaaaaaaaaaaaaC
CaaaaaaaaaaaaaaaaaaaaaassssaaaaaaaaaaaaaaaaaaaaaaC
CaaaaaaaaaaaaaaaaaaaaaassssaaaaaaaaaaaaaaaaaaaaaaC
CaaaaaaaaaaaaaaaaaaaaaassssaaaaaaaaaaaaaaaaaaaaaaC
CaaaaaaaaaaaaaaaaaaaaaassssaaaaaaaaaaaaaaaaaaaaaaC
CaaaaaaaaaaaaaaaaaaaaaassssaaaaaaaaaaaaaaaaaaaaaaC
CaaaaaaaaaaaaaaaaaaaaaassssaaaaaaaaaaaaaaaaaaaaaaC
CaaaaaaaaaaaaaaaaaaaaaassssaaaaaaaaaaaaaaaaaaaaaaC
CaaaaaaaaaaaaaaaaaaaaaassssaaaaaaaaaaaaaaaaaaaaaaC
CaaaaaaaaaaaaaaaaaaaaaassssaaaaaaaaaaaaaaaaaaaaaaC
CaaaaaaaaaaaaaaaaaaaaaassssaaaaaaaaaaaaaaaaaaaaaaC
CaaaaaaaaaaaaaaaaaaaaaassssaaaaaaaaaaaaaaaaaaaaaaC
CaaaaaaaaaaaaaaaaaaaaaassssaaaaaaaaaaaaaaaaaaaaaaC
CaaaaaaaaaaaaaaaaaaaaaassssaaaaaaaaaaaaaaaaaaaaaaC
CaaaaaaaaaaaaaaaaaaaaaassssaaaaaaaaaaaaaaaaaaaaaaC
CaaaaaaaaaaaaaaaaaaaaaassssaaaaaaaaaaaaaaaaaaaaaaC
CCCCCCCCCCCCCCCCCCCCCCCCCCCCCCCCCCCCCCCCCCCCCCCCCC
"}
